...................#
.....###########....
.......#.......#....
...............#....
....................
......#.......#.....
....................
.............#......
....................
..#.................
....................
....................
...............#....
.#..................
....................
.....##########.....
....................
....................
.........#..........
#..................#