...................#
.....###########....
...............#....
...............#....
...............#....
...#................
....................
................#...
....................
....................
....................
.........#..........
....................
....................
....................
.....##########.....
....................
.........#..........
....................
#..................#